25
1111111111111111011111111111111111111111111
1111111111111111011111111111111111111111111
1111111111111111011111111111111111111111111
1111111111111111011111111111111111111111111
1111111111111111011111111111111111111111111
1111111111111111011111111111111100000111111
1111111111111111211111111111111100500000R01
1111111111111111011111111111111100511111111
1111111111105000000400666666660050511111111
1111111111105111111111100000011150511111111
1111111111105111111111177777711150511111111
1111111111105111111111111111111150511111111
1111111111105031111111111111111150511111111
1111111111111111111111111111111100011111111
1111111111111111111111111111111177711111111
1111111111111111111111111111111111111111111
1111111111111111111111111111111111111111111
1111111111111111111111111111111111111111111
1111111111111111111111111111111111111111111
1111111111111111111111111111111111111111111
1111111111111111111111111111111111111111111
1111111111111111111111111111111111111111111
1111111111111111111111111111111111111111111
1111111111111111111111111111111111111111111